
HMD	HEARD AND MC DONALD ISLANDS
ASM	AMERICAN SAMOA
MAR	MOROCCO
LVA	LATVIA
CPV	CAPE VERDE
SJM	SVALBARD AND JAN MAYEN ISLANDS
MLI	MALI
GBR	THE UNITED KINGDOM
FIN	FINLAND
BVT	BOUVET ISLAND
IND	INDIA
DNK	DENMARK
MMR	MYANMAR (BURMA)
WLF	WALLIS AND FUTUNA ISLANDS
BHS	BAHAMAS
BFA	BURKINA FASO
PYF	FRENCH POLYNESIA
CZE	CZECH REPUBLIC
ARG	ARGENTINA
CIV	COTE D'IVOIRE
SVN	SLOVENIA
ECU	ECUADOR
VEN	VENEZUELA
SDN	SUDAN
BRB	BARBADOS
SLV	EL SALVADOR
ZMB	ZAMBIA
TGO	TOGO
CHL	CHILE
NAM	NAMIBIA
MDA	MOLDOVA, REPUBLIC OF
MYS	MALAYSIA
TUV	TUVALU
FRA	FRANCE
CAN	CANADA
AFG	AFGHANISTAN
PAN	PANAMA
DOM	DOMINICAN REPUBLIC
HND	HONDURAS
AUT	AUSTRIA
TON	TONGA
CYM	CAYMAN ISLANDS
FRO	FAROE ISLANDS
DMA	DOMINICA
COK	COOK ISLANDS
GBR	UNITED KINGDOM
AGO	ANGOLA
HKG	HONG KONG
FJI	FIJI
NCL	NEW CALEDONIA
GUM	GUAM
TCA	TURKS AND CAICOS ISLANDS
SLB	SOLOMON ISLANDS
CAF	CENTRAL AFRICAN REPUBLIC
UMI	U.S. MINOR ISLANDS
ERI	ERITREA
TZA	TANZANIA, UNITED REPUBLIC OF
FLK	FALKLAND ISLANDS
PCN	PITCAIRN
JOR	JORDAN
BIH	BOSNIA AND HERZEGOWINA
CYP	CYPRUS
VAT	HOLY SEE (VATICAN CITY STATE)
SUR	SURINAME
GRL	GREENLAND
GLP	GUADELOUPE
LSO	LESOTHO
COL	COLOMBIA
VUT	VANUATU
BRN	BRUNEI DARUSSALAM
AUS	AUSTRALIA
ABW	ARUBA
DEU	GERMANY
SSD	SOUTH SUDAN
MHL	MARSHALL ISLANDS
SYR	SYRIAN ARAB REPUBLIC
MNG	MONGOLIA
GNB	GUINEA-BISSAU
LCA	SAINT LUCIA
PAK	PAKISTAN
UZB	UZBEKISTAN
ESH	WESTERN SAHARA
BDI	BURUNDI
BGR	BULGARIA
RWA	RWANDA
TWN	TAIWAN, PROVINCE OF CHINA
COG	CONGO
DZA	ALGERIA
SWE	SWEDEN
KIR	KIRIBATI
KGZ	KYRGYZSTAN
TTO	TRINIDAD AND TOBAGO
PRT	PORTUGAL
ESP	SPAIN
NGA	NIGERIA
PHL	PHILIPPINES
TKM	TURKMENISTAN
VIR	VIRGIN ISLANDS (U.S.)
AZE	AZERBAIJAN
ZWE	ZIMBABWE
LBN	LEBANON
YEM	YEMEN
FXX	FRANCE METROPOLITAN
BWA	BOTSWANA
NRU	NAURU
TMP	EAST TIMOR
MUS	MAURITIUS
MEX	MEXICO
MNP	NORTHERN MARIANA ISLANDS
GHA	GHANA
PER	PERU
SHN	ST. HELENA
VNM	VIET NAM
ARM	ARMENIA
IOT	BRITISH INDIAN OCEAN TERRITORY
ISR	ISRAEL
PHL	REPUBLIKA NG PILIPINAS
TJK	TAJIKISTAN
NZL	NEW ZEALAND
TCD	CHAD
KWT	KUWAIT
ATF	FRENCH SOUTHERN TERRITORIES
ITA	ITALY
PNG	PAPUA NEW GUINEA
KNA	SAINT KITTS AND NEVIS
CMR	CAMEROON
MDV	MALDIVES
ROM	ROMANIA
TUN	TUNISIA
MYT	MAYOTTE
HUN	HUNGARY
MKD	MACEDONIA
NFK	NORFOLK ISLAND
BEL	BELGIUM
STP	SAO TOME AND PRINCIPE
BHR	BAHRAIN
NLD	THE NETHERLANDS
USA	UNITED STATES
BLR	BELARUS
GRC	GREECE
GAB	GABON
FSM	MICRONESIA, FEDERATED STATES OF
ANT	NETHERLANDS ANTILLES
RUS	RUSSIAN FEDERATION
KEN	KENYA
VCT	SAINT VINCENT AND THE GRENADINES
GMB	GAMBIA
MNE	MONTENEGRO
LBY	LIBYAN ARAB JAMAHIRIYA
GRD	GRENADA
WSM	SAMOA
TUR	TURKEY
TKL	TOKELAU
COD	CONGO, THE DRC
GUY	GUYANA
UGA	UGANDA
ISL	ICELAND
SOM	SOMALIA
CHE	SWITZERLAND
AND	ANDORRA
PLW	PALAU
MLT	MALTA
SEN	SENEGAL
SAU	SAUDI ARABIA
URY	URUGUAY
PRK	KOREA, D.P.R.O.
SGP	SINGAPORE
CRI	COSTA RICA
IRL	IRELAND
LUX	LUXEMBOURG
ATG	ANTIGUA AND BARBUDA
CUB	CUBA
SVK	SLOVAKIA
PRY	PARAGUAY
BRA	BRAZIL
VGB	VIRGIN ISLANDS (BRITISH)
REU	REUNION
JAM	JAMAICA
BIH	BOSNIA AND HERZEGOVINA
IRQ	IRAQ
SLE	SIERRA LEONE
NIC	NICARAGUA
NER	NIGER
NOR	NORWAY
SMR	SAN MARINO
AIA	ANGUILLA
MRT	MAURITANIA
SPM	ST. PIERRE AND MIQUELON
GUF	FRENCH GUIANA
LTU	LITHUANIA
CHN	CHINA
CHN	THE PEOPLE'S REPUBLIC OF CHINA
MDG	MADAGASCAR
KOR	SOUTH KOREA
CCK	COCOS (KEELING) ISLANDS
COM	COMOROS
GIN	GUINEA
BOL	BOLIVIA
GIB	GIBRALTAR
LBR	LIBERIA
HTI	HAITI
EST	ESTONIA
JPN	JAPAN
ALB	ALBANIA
DJI	DJIBOUTI
LAO	LAOS
SWZ	SWAZILAND
GEO	GEORGIA
MWI	MALAWI
GNQ	EQUATORIAL GUINEA
SGS	SOUTH GEORGIA AND SOUTH S.S.
PRI	PUERTO RICO
NPL	NEPAL
KOR	KOREA, REPUBLIC OF
KAZ	KAZAKHSTAN
LIE	LIECHTENSTEIN
POL	POLAND
SVK	SLOVAKIA (SLOVAK REPUBLIC)
CXR	CHRISTMAS ISLAND
PHL	THE PHILIPPINES
UKR	UKRAINE
BLZ	BELIZE
GTM	GUATEMALA
LKA	SRI LANKA
THA	THAILAND
CHN	中华人民共和国
MTQ	MARTINIQUE
MCO	MONACO
MAC	MACAU
BTN	BHUTAN
SRB	SERBIA
MSR	MONTSERRAT
RUS	RUSSIA
NLD	NETHERLANDS
KHM	CAMBODIA
IRN	IRAN (ISLAMIC REPUBLIC OF)
NIU	NIUE
BMU	BERMUDA
USA	THE UNITED STATES
IDN	INDONESIA
MOZ	MOZAMBIQUE
EGY	EGYPT
BEN	BENIN
HRV	CROATIA
ATA	ANTARCTICA
QAT	QATAR
OMN	OMAN
BGD	BANGLADESH
ZAF	SOUTH AFRICA
ARE	UNITED ARAB EMIRATES
